11 21
#####################
#*  %       #       #
#G  #####   #   #####
# T #       #       #
# O #   #########   #
#   #           #   #
#   #########   #   #
#   #       #   #   #
#   #   #####   #   #
#   #               #
#####################